OOOOOOOOOOOOOOOOOO
O................O
O.OOOOO...O.O.OO.O
O.O...O........O.O
O...O...O.OO.....O
O..OOOOOO.O...O..O
O................O
OOOOOOO...OOOOOOOO
O.....O...O......O
O.....O...O...O..O
O.........O......O
O.....O...OOO.O..O
O.....O...O......O
O..OO.OOOOOOO....O
O.OO....O........O
O..O..O.O.O.OOOOOO
O.....O...O.O....O
OOOOOOOOOOOOOOOOOO
