OOOOOOOOOOOOOOOOOO
O................O
O................O
O................O
O................O
O.......O........O
O.......O........O
O.......O........O
O..OOOOOOOOOOOO..O
O.......O........O
O.......O........O
OOOOOO..O..OOOOOOO
O.......O........O
O.......O........O
OOOOOOOOOOOOOO...O
O................O
O................O
OOOOOOOOOOOOOOOOOO
